5
-1 2 2 2 -1
2 1 -1 2 3
3 -1 -1 0 3
2 -1 -1 2 3
-1 -1 2 -1 -1

-1 2 -1 -1 3
-1 2 -1 2 -1
3 0 2 1 2
3 -1 -1 2 -1
-1 1 3 2 -1

7
-1 -1 3 2 -1 2 -1
2 1 -1 1 2 -1 -1
-1 3 3 2 2 2 3 -1
2 -1 1 -1 1 1 -1
-1 -1 2 3 2 2 -1
-1 -1 -1 3 -1 3 -1
3 -1 0 2 -1 -1 -1

-1 -1 2 2 1 -1 -1
3 -1 2 -1 -1 -1 3
1 2 3 2 -1 2 2
-1 -1 -1 2 2 3 -1
3 2 -1 -1 2 -1 -1
-1 -1 -1 -1 3 2 -1
3 -1 -1 -1 3 2 3

10
-1 -1 -1 -1 -1 -1 -1 -1 3 3
2 1 -1 3 -1 -1 2 -1 -1 1
2 -1 2 -1 -1 3 2 -1 2 3
1 -1 -1 3 1 2 0 3 -1 2
-1 2 2 2 2 -1 -1 -1 1 -1
-1 2 2 2 -1 -1 0 -1 2 -1
1 2 2 3 2 -1 -1 -1 2 -1
3 2 -1 -1 2 -1 -1 -1 -1 1
2 -1 -1 -1 1 2 2 2 3 -1
-1 -1 -1 -1 2 -1 2 -1 -1 -1

-1 -1 3 1 -1 -1 -1 3 -1 3
2 -1 -1 3 -1 1 -1 -1 -1 -1
-1 -1 2 -1 1 2 1 -1 -1 3
2 2 2 -1 2 -1 -1 3 0 -1
-1 -1 2 1 -1 -1 2 -1 3 2
1 -1 2 2 -1 -1 2 -1 -1 -1
-1 -1 3 -1 -1 2 2 -1 1 3
3 1 2 1 -1 -1 -1 3 -1 -1
2 -1 -1 -1 3 -1 -1 -1 -1 -1
-1 -1 -1 1 -1 -1 2 -1 3 -1

15
-1 2 2 2 -1 -1 2 3 3 -1 -1 1 2 1 3
3 1 -1 2 2 3 -1 -1 1 2 3 2 -1 -1 3
3 -1 2 -1 -1 1 1 2 -1 -1 -1 -1 -1 -1 2
1 -1 -1 3 3 3 -1 -1 -1 -1 -1 2 2 -1 -1
2 -1 -1 -1 -1 1 2 2 2 -1 -1 3 1 3 2
-1 -1 -1 -1 -1 2 -1 2 3 -1 -1 -1 -1 -1 1
-1 -1 -1 2 -1 -1 -1 -1 2 -1 -1 -1 1 3 -1
3 1 -1 1 2 2 3 2 1 2 -1 -1 3 -1 2
-1 1 -1 2 2 3 2 2 -1 -1 -1 -1 2 -1 3
3 -1 3 2 -1 1 -1 1 -1 2 1 3 -1 -1 2
2 2 2 -1 -1 3 -1 -1 -1 1 -1 -1 1 -1 2
2 2 -1 2 -1 1 2 -1 0 2 2 3 -1 -1 3
3 0 -1 1 -1 -1 -1 -1 2 -1 1 2 -1 2 -1
3 2 -1 1 -1 -1 -1 -1 -1 2 2 3 -1 1 3
-1 1 2 2 3 2 -1 1 -1 -1 -1 -1 -1 -1 -1

2 -1 -1 -1 -1 -1 2 3 -1 2 -1 -1 2 -1 -1
-1 3 -1 -1 -1 1 -1 2 3 -1 3 -1 2 2 3
-1 2 2 0 -1 -1 3 -1 -1 -1 1 2 -1 1 -1
-1 2 3 -1 3 -1 -1 2 -1 -1 2 2 -1 3 2
3 -1 2 -1 -1 -1 -1 -1 -1 1 -1 2 3 2 -1
2 -1 -1 -1 2 -1 2 1 -1 2 -1 -1 -1 -1 2
3 1 2 2 2 3 -1 2 -1 1 1 -1 -1 -1 -1
-1 -1 3 -1 -1 -1 2 -1 -1 -1 2 -1 -1 3 -1
3 -1 -1 -1 -1 -1 -1 3 3 -1 2 -1 -1 -1 -1
-1 3 -1 3 1 -1 2 -1 2 -1 2 3 2 -1 -1
-1 -1 -1 -1 -1 -1 -1 -1 3 -1 3 1 -1 2 -1
2 3 -1 3 0 -1 -1 -1 -1 1 -1 -1 3 2 -1
-1 2 2 -1 -1 -1 3 -1 -1 2 2 -1 -1 3 -1
-1 -1 -1 2 -1 -1 0 -1 -1 3 2 -1 3 -1 -1
-1 -1 1 -1 3 -1 -1 -1 2 -1 -1 -1 -1 2 -1

20
3 3 -1 -1 -1 -1 2 -1 2 0 -1 -1 3 3 -1 -1 -1 -1 1 -1
2 -1 2 -1 -1 -1 2 -1 -1 2 -1 -1 -1 1 -1 2 1 2 -1 -1
3 -1 -1 0 -1 -1 2 2 -1 -1 -1 -1 -1 2 -1 -1 2 -1 -1 -1
2 -1 -1 -1 -1 -1 2 2 1 -1 -1 -1 -1 -1 2 3 1 -1 -1 -1
-1 2 1 -1 1 -1 -1 -1 2 3 1 -1 -1 3 2 3 -1 1 1 3
-1 -1 0 -1 2 3 2 1 1 -1 2 -1 2 -1 -1 2 2 2 -1 3
-1 2 -1 -1 -1 -1 -1 3 3 -1 1 -1 -1 -1 3 2 -1 -1 -1 3
3 -1 -1 2 1 -1 -1 2 -1 1 2 2 -1 0 3 -1 1 -1 1 3
3 1 3 3 2 -1 1 2 -1 -1 -1 1 3 3 -1 -1 3 -1 -1 3
-1 -1 -1 1 -1 -1 -1 -1 -1 2 -1 -1 2 2 1 -1 -1 2 -1 -1
1 -1 3 2 -1 3 -1 2 2 3 -1 -1 -1 2 -1 -1 -1 -1 -1 -1
-1 -1 3 0 2 1 1 -1 -1 2 -1 -1 -1 1 3 -1 1 2 1 3
-1 1 3 2 2 -1 3 -1 1 1 -1 2 3 3 -1 -1 1 2 -1 3
-1 3 -1 2 -1 1 -1 -1 -1 -1 2 -1 -1 -1 -1 3 1 3 -1 -1
-1 -1 -1 2 -1 3 -1 2 1 -1 3 -1 -1 -1 -1 -1 -1 3 2 3
2 2 2 2 -1 2 -1 2 2 -1 2 0 -1 2 -1 -1 -1 -1 1 -1
-1 2 1 2 -1 3 -1 -1 3 1 -1 -1 -1 1 2 -1 3 -1 -1 -1
-1 -1 -1 -1 -1 2 -1 -1 3 2 3 -1 -1 2 2 -1 2 -1 -1 -1
-1 -1 -1 -1 -1 3 -1 -1 2 -1 -1 1 -1 0 2 2 1 2 3 -1
-1 -1 -1 -1 1 -1 -1 -1 2 2 2 3 3 3 3 -1 2 -1 -1 -1

-1 -1 -1 1 -1 2 -1 2 -1 2 -1 3 2 3 -1 2 3 -1 2 -1
2 -1 -1 1 2 1 2 -1 3 -1 -1 -1 2 1 3 -1 -1 1 -1 -1
-1 2 -1 2 -1 2 -1 3 -1 2 3 2 -1 -1 2 2 3 -1 3 2
-1 -1 -1 1 -1 -1 -1 -1 3 -1 -1 -1 -1 1 -1 -1 -1 -1 1 2
-1 -1 -1 2 -1 -1 3 2 -1 -1 -1 1 -1 -1 2 1 -1 -1 -1 2
2 1 -1 -1 2 -1 -1 2 3 2 2 2 2 2 -1 -1 -1 -1 -1 2
-1 2 3 -1 2 -1 -1 -1 -1 2 2 -1 -1 -1 -1 -1 3 1 2 -1
-1 -1 2 -1 2 0 3 -1 3 2 -1 2 1 1 2 1 -1 -1 -1 -1
2 -1 -1 2 3 -1 -1 -1 -1 2 2 3 2 3 -1 -1 -1 2 1 3
3 -1 -1 -1 -1 -1 -1 -1 -1 -1 1 3 -1 -1 1 -1 2 -1 -1 3
-1 2 1 -1 -1 3 1 2 0 2 2 2 -1 1 -1 -1 -1 2 -1 2
3 2 3 3 -1 2 -1 3 -1 -1 -1 -1 -1 2 3 -1 -1 0 3 -1
-1 2 -1 -1 3 2 -1 -1 -1 2 -1 3 -1 -1 -1 -1 -1 -1 -1 1
-1 -1 2 -1 -1 -1 -1 2 -1 1 1 1 -1 -1 3 3 -1 1 -1 -1
3 -1 0 -1 -1 -1 1 1 2 -1 -1 2 -1 -1 -1 -1 -1 -1 2 -1
-1 3 -1 -1 -1 -1 -1 3 2 -1 -1 -1 2 -1 1 1 2 -1 2 2
-1 -1 -1 1 -1 -1 2 -1 -1 -1 2 -1 -1 2 -1 3 -1 1 -1 2
3 -1 3 0 -1 2 -1 -1 -1 -1 -1 2 2 2 1 1 -1 2 3 0
-1 -1 -1 2 -1 1 1 3 -1 2 1 -1 -1 2 1 -1 -1 -1 -1 2
3 -1 3 2 3 -1 -1 -1 -1 3 -1 2 2 2 2 2 2 3 -1 -1

30
-1 3 -1 -1 -1 2 -1 2 2 -1 -1 2 3 -1 3 -1 -1 -1 -1 -1 3 3 -1 3 -1 3 -1 1 -1 3
1 -1 1 -1 2 -1 2 -1 -1 3 -1 1 2 -1 2 -1 -1 -1 2 -1 -1 1 1 0 -1 -1 1 -1 -1 -1
3 3 -1 -1 1 -1 1 1 -1 -1 2 1 2 -1 -1 -1 1 1 2 2 -1 -1 -1 -1 -1 -1 -1 -1 0 3
-1 -1 3 -1 -1 2 3 -1 3 -1 -1 2 2 3 3 -1 3 3 3 -1 -1 2 2 2 1 3 2 3 -1 3
-1 2 -1 2 -1 -1 -1 -1 1 -1 2 1 2 2 0 2 1 -1 -1 -1 1 -1 2 3 2 -1 -1 -1 1 -1
2 2 3 2 1 -1 2 2 -1 2 -1 2 -1 -1 -1 -1 -1 -1 2 -1 1 3 -1 -1 -1 -1 2 3 -1 3
3 -1 -1 1 0 2 -1 2 -1 1 -1 -1 2 2 3 1 1 -1 2 -1 1 -1 -1 -1 1 -1 2 -1 2 -1
-1 2 1 -1 2 -1 -1 0 2 2 -1 -1 2 -1 2 1 -1 2 -1 -1 -1 3 1 -1 0 -1 -1 -1 -1 -1
-1 2 -1 2 -1 1 2 -1 -1 2 -1 1 -1 2 -1 1 -1 2 3 1 -1 -1 -1 -1 -1 -1 3 -1 3 2
3 -1 3 2 1 -1 2 -1 1 -1 -1 2 1 1 -1 2 3 -1 -1 2 -1 -1 1 2 -1 -1 -1 2 -1 -1
3 -1 -1 1 2 -1 -1 -1 2 3 2 -1 1 -1 2 2 3 -1 -1 1 -1 3 2 2 1 3 -1 3 -1 -1
-1 2 -1 -1 -1 2 3 1 -1 1 -1 -1 -1 -1 -1 -1 2 -1 -1 -1 -1 -1 -1 -1 -1 -1 -1 -1 2 -1
1 0 3 2 -1 -1 -1 2 -1 -1 -1 1 -1 0 -1 -1 -1 3 1 2 2 1 2 1 -1 -1 1 -1 2 -1
-1 3 -1 -1 2 -1 3 -1 -1 1 3 -1 -1 0 -1 -1 3 -1 1 -1 -1 -1 1 3 -1 3 1 -1 -1 2
2 -1 -1 -1 -1 -1 -1 -1 -1 3 -1 1 3 3 -1 -1 -1 1 0 -1 -1 -1 -1 -1 2 -1 2 -1 -1 2
-1 3 -1 1 -1 -1 2 -1 -1 -1 -1 -1 1 -1 -1 -1 2 0 2 -1 -1 2 1 -1 -1 -1 3 -1 -1 2
-1 1 0 -1 -1 -1 1 -1 3 1 2 1 2 2 2 -1 2 2 3 -1 -1 -1 2 1 1 0 2 -1 -1 3
-1 2 -1 -1 -1 -1 2 -1 -1 -1 -1 -1 -1 1 -1 -1 2 -1 2 0 2 -1 3 -1 -1 -1 3 -1
2 -1 -1 1 2 1 -1 3 -1 -1 -1 2 -1 -1 -1 -1 1 3 2 -1 -1 -1 1 -1 -1 1 -1 -1 -1 2
-1 2 -1 2 -1 1 -1 -1 3 -1 -1 0 2 -1 -1 3 0 2 -1 -1 -1 -1 -1 -1 1 1 -1 -1 3 -1
3 -1 2 1 2 0 2 1 -1 0 3 -1 -1 -1 2 -1 -1 -1 2 -1 2 2 1 1 -1 -1 -1 -1 -1 3
-1 -1 2 -1 2 -1 2 -1 2 1 3 -1 1 -1 -1 3 2 -1 0 2 2 2 2 3 2 -1 -1 2 3 -1
3 -1 1 -1 2 1 1 -1 -1 -1 -1 3 2 3 1 2 -1 1 1 -1 -1 -1 2 -1 -1 2 1 -1 -1 3
-1 -1 -1 -1 -1 -1 -1 -1 -1 -1 -1 3 -1 3 -1 2 -1 -1 1 2 2 -1 3 -1 3 -1 -1 -1 3 -1
-1 2 -1 3 -1 2 3 -1 -1 0 -1 -1 2 2 -1 -1 3 -1 -1 -1 -1 -1 -1 -1 -1 -1 -1 2 -1 3
3 1 1 -1 2 0 -1 -1 1 2 -1 -1 2 -1 3 1 -1 2 1 2 2 -1 -1 3 3 -1 -1 -1 -1 -1
2 -1 -1 1 -1 -1 -1 2 3 -1 2 -1 -1 2 -1 1 -1 2 2 -1 -1 -1 3 -1 -1 -1 2 -1 -1 -1
2 -1 1 -1 2 1 1 -1 -1 -1 2 -1 -1 -1 3 1 3 -1 1 -1 -1 -1 2 2 2 -1 3 -1 -1 -1
-1 -1 2 -1 2 -1 -1 -1 -1 1 -1 -1 -1 -1 -1 -1 3 1 -1 -1 2 -1 -1 2 2 -1 -1 1 2 -1
-1 3 1 -1 2 2 -1 3 -1 1 -1 -1 -1 3 -1 2 3 -1 -1 1 -1 -1 3 -1 -1 2 -1 3 2 -1

1